
 HHHH HHHH
 H       M
 H       M
 H       3
 H       3
 H       M
 H       M
 H       3
 H    4443
 H    555M
 H    222M
 H    9993
 H    1113
 HHHHHHHHM