
 H       H
 HH     HH
 HHH   HHH
 H6HHHHH6H
  H66666H
   HHHHH
    HHH
    HHH
   HHHHH
  H22222H
 HHHHHHHHH
 H2H   H2H
 HH     HH
 H       H